1....tt..w..
.....tt..w..
....nt..ww..
...nn..ww...
..nn..ww..tt
.tt..ww..ttt
ttt..ww..tt.
tt..ww..nn..
...ww..nn...
..ww..tn....
..w..tt.....
..w..tt....2
